SSSSPPPSSSSESSS
SSSSSSPSSSSSPPP
SSSSPPPSSSSSPSS
SSSSSSSSSSSSPSS
SSSSSSSSSSPPPSS
SSSPPPPSSSSSSSS
SSSPSSSSSSSSSTS
SSSPSSSSSSSSSSS
SSSPSSPPSSSSSSS
SSSPPSSPSSSSSSS
SSSPPPPPSSSSSSS
SSSSSSSSSSSSSSS
SSSSSSSSPPPPPPP
SSSSSSSSPPSSSPP
SSSSSSSSSSSSSPP