SPSSPPSPPSSPSSS
SPSPSSPPPSSSPSP
PPSSPPPSSPPSPPS
SSPSSPSSSPPPSPS
SSSPPSSPSPPPSPS
PSPSPPPPSPSSSPS
SSPSPPSPSPPSPPS
SPSSSSPSPSSSSPS
PPSSSPSSPSSSSSS
PPSPPPSPPPPPPPS
PPPPPSSPSSPSSSP
PSSSSSPPSSSPPSS
PSPPSPPSPPPPSPS
SPPSPPSPSPSSSPS
PSPSSPPPSPPSPPS